[
	[2,2,2,3,3,3,3,3,3,3,3,3,3,2,2],
	[2,2,2,2,2,2,3,3,3,3,2,5,2,2,2],
	[2,2,2,4,4,2,3,2,3,3,4,4,2,3,3],
	[2,2,4,4,4,4,3,2,3,3,5,5,3,3,3],
	[2,2,4,4,4,4,3,2,2,3,3,5,3,3,3],
	[2,2,2,4,4,3,3,3,3,3,3,5,5,5,5],
	[2,2,2,6,6,6,3,3,3,3,3,5,5,5,5],
	[2,2,2,3,6,2,2,3,3,5,5,5,5,4,4],
	[2,2,2,3,3,2,2,6,3,5,5,5,4,4,4],
	[2,2,3,3,3,3,6,6,6,5,5,4,4,4,4],
	[2,2,3,3,3,3,3,3,5,5,5,4,4,4,4],
	[2,2,3,3,3,3,3,3,5,5,4,4,4,4,4],
	[2,2,3,2,2,3,3,5,5,5,4,4,4,4,4],
	[2,2,2,2,2,2,3,5,5,5,4,4,4,4,4],
	[2,2,2,2,2,2,3,5,5,5,4,4,4,4,4],
]